R  1920 1080
NO        ./textures/walls/110.xpm
SO ./textures/walls/9.xpm
WE ./textures/walls/112.xpm
EA ./textures/walls/188.xpm
S ./textures/sprites/20.xpm
F 100, 100, 100
C 170, 170, 210




0111111111111111111111111
1000000000110000000000001
        1011000001110000002000001
        1001000000000000000000001
111111111011000001110000000000001
100000000011000001110111111111111
11110111111111011100000010001
11110111111111011101010000001
11000000110111011100000010001
11112000000011111110000001001
   100000001111  1101010010011111111111
11110001110101111111011110S000000001111
11110111 1110101 1011110100011111111111
11111111 1111111 111111111111
